###########
#F#########
###########
#         #
# ####### #
# #     # #
# # ##### #
# #       #
# ####### #
#         #
###########