#F#########
#   #     #
# ####### #
#     # # #
# ### # # #
# # # # # #
# # ### # #
# #     # #
# ##### # #
#         #
###########